1111111111111111111111111111111111
1000000000000000000000000011100001
1111111111111111111111111000000001
1111111111110000000000100000000001
1111111111111111111111111111111111






