111111
100001
101101
100P01
111101
111111

