1111111111111
1000000001001
1011111101011
1010000101011
1010111101001
100P000001001
1111111101011
1000000001011
1011111111011
1010000000001
1111111111111

